UBI = "countries/Ubihia.txt"
BLK = "countries/Balkaria.txt"
CBD = "countries/Cabarda.txt"
OST = "countries/Osetia.txt"
IGS = "countries/Ingushetia.txt"
IKR = "countries/Chechnya.txt"
KMK = "countries/Kumikia.txt"
AVH = "countries/Avar.txt"
TSH = "countries/Tsahur.txt"
ADI = "countries/Adigea.txt"
BZE = "countries/Bzedugia.txt"
ABA = "countries/Abadzehia.txt"
ABZ = "countries/Abazgia.txt"
TMG = "countries/Temirgoi.txt"
SKI = "countries/Sheki.txt"
KLI = "countries/Kartli.txt"
ABH = "countries/Abhazia.txt"
SVA = "countries/Svanetia.txt"
MEG = "countries/Megrelia.txt"
GUR = "countries/Guria.txt"
AJA = "countries/Ajaria.txt"
KHE = "countries/Kahetia.txt"
DAG = "countries/Dagestan.txt"
AZB = "countries/Azerbaidzan.txt"
ERI = "countries/Erevan.txt"
URM = "countries/Urmia.txt"
TEB = "countries/Tebriz.txt"
GAN = "countries/Gandza.txt"
TAL = "countries/Talesh.txt"
JAV = "countries/Javat.txt"
CUB = "countries/Cuba.txt"
LAZ = "countries/Lazistan.txt"
BAK = "countries/Baku.txt"
DER = "countries/Derbent.txt"
NHC = "countries/Nahichevan.txt"
KRB = "countries/Karabahh.txt"
EGE = "countries/Meragee.txt"
CAU = "countries/Caucasus.txt"